//MAP CONVERTED BY dmm2tgm.py THIS HEADER COMMENT PREVENTS RECONVERSION, DO NOT REMOVE
"a" = (
/turf/closed/wall/mineral/plastitanium,
/area/shuttle/arrival)
"b" = (
/turf/closed/wall/mineral/titanium/nodiagonal,
/area/shuttle/arrival)
"c" = (
/turf/closed/wall/mineral/titanium,
/area/shuttle/arrival)
"d" = (
/obj/machinery/door/airlock/shuttle{
	name = "Arrival Shuttle Airlock"
	},
/obj/effect/turf_decal/stripes/line,
/obj/effect/turf_decal/stripes/line{
	dir = 1
	},
/turf/open/floor/mineral/plastitanium,
/area/shuttle/arrival)
"e" = (
/obj/structure/sign/nanotrasen,
/turf/closed/wall/mineral/titanium,
/area/shuttle/arrival)
"f" = (
/obj/structure/window/shuttle,
/obj/structure/grille,
/turf/open/floor/plating,
/area/shuttle/arrival)
"g" = (
/turf/template_noop,
/area/template_noop)
"h" = (
/obj/structure/sign/warning/fire,
/turf/closed/wall/mineral/titanium,
/area/shuttle/arrival)
"i" = (
/obj/effect/turf_decal/delivery,
/obj/item/pizzabox/margherita,
/obj/item/pizzabox/meat,
/obj/item/pizzabox/mushroom,
/obj/item/pizzabox/pineapple,
/obj/item/pizzabox/vegetable,
/turf/open/floor/mineral/plastitanium,
/area/shuttle/arrival)
"j" = (
/obj/effect/turf_decal/bot,
/obj/structure/chair/comfy/shuttle,
/obj/machinery/light{
	icon_state = "tube";
	dir = 1
	},
/turf/open/floor/mineral/plastitanium,
/area/shuttle/arrival)
"k" = (
/obj/effect/turf_decal/bot,
/obj/structure/chair/comfy/shuttle,
/turf/open/floor/mineral/plastitanium,
/area/shuttle/arrival)
"l" = (
/obj/effect/turf_decal/bot,
/obj/structure/chair/comfy/shuttle,
/obj/machinery/status_display/evac{
	pixel_y = 32
	},
/obj/machinery/light{
	icon_state = "tube";
	dir = 1
	},
/turf/open/floor/mineral/plastitanium,
/area/shuttle/arrival)
"m" = (
/obj/effect/turf_decal/stripes/line{
	dir = 8
	},
/obj/effect/turf_decal/stripes/line{
	dir = 4
	},
/turf/open/floor/noslip,
/area/shuttle/arrival)
"n" = (
/obj/structure/shuttle/engine/propulsion/left{
	dir = 8
	},
/obj/effect/turf_decal/stripes/line{
	dir = 8
	},
/turf/open/floor/plating/airless,
/area/shuttle/arrival)
"o" = (
/obj/structure/window/shuttle,
/obj/structure/grille,
/obj/structure/shuttle/engine/heater{
	dir = 8
	},
/turf/open/floor/plating,
/area/shuttle/arrival)
"q" = (
/obj/effect/turf_decal/delivery,
/obj/item/storage/toolbox/mechanical,
/obj/item/storage/toolbox/emergency,
/obj/item/storage/toolbox/electrical,
/obj/item/storage/box/silver_ids,
/obj/item/storage/box/PDAs{
	pixel_x = 4;
	pixel_y = 4
	},
/obj/structure/closet/crate,
/turf/open/floor/mineral/plastitanium,
/area/shuttle/arrival)
"r" = (
/obj/effect/turf_decal/stripes/line{
	dir = 8
	},
/obj/effect/turf_decal/stripes/corner{
	dir = 4
	},
/obj/effect/turf_decal/stripes/corner,
/turf/open/floor/noslip,
/area/shuttle/arrival)
"s" = (
/obj/effect/turf_decal/delivery,
/obj/structure/closet/crate/secure/weapon,
/obj/item/holo/esword,
/obj/item/gun/ballistic/revolver,
/obj/item/ammo_box/a357,
/obj/item/ammo_box/a357,
/obj/item/gun/ballistic/revolver,
/obj/item/holo/esword,
/turf/open/floor/mineral/plastitanium,
/area/shuttle/arrival)
"t" = (
/obj/effect/turf_decal/bot,
/obj/effect/turf_decal/stripes/corner{
	dir = 8
	},
/obj/machinery/light/small{
	dir = 8
	},
/obj/machinery/suit_storage_unit/ert,
/turf/open/floor/mineral/plastitanium,
/area/shuttle/arrival)
"u" = (
/obj/structure/shuttle/engine/propulsion{
	dir = 8
	},
/obj/effect/turf_decal/stripes/line{
	dir = 8
	},
/obj/docking_port/mobile/arrivals{
	dir = 4;
	name = "ERT restoration shuttle";
	perma_docked = 1
	},
/turf/open/floor/plating/airless,
/area/shuttle/arrival)
"w" = (
/obj/effect/turf_decal/stripes/line{
	dir = 1
	},
/obj/effect/turf_decal/stripes/line,
/turf/open/floor/noslip,
/area/shuttle/arrival)
"x" = (
/obj/effect/turf_decal/bot,
/obj/structure/chair/comfy/shuttle{
	dir = 1
	},
/obj/machinery/light,
/turf/open/floor/mineral/plastitanium,
/area/shuttle/arrival)
"y" = (
/obj/machinery/requests_console{
	department = "Arrival shuttle";
	name = "Arrivals Shuttle console"
	},
/turf/closed/wall/mineral/titanium/nodiagonal,
/area/shuttle/arrival)
"z" = (
/obj/structure/flora/ausbushes/grassybush,
/obj/structure/flora/ausbushes/lavendergrass,
/obj/structure/flora/ausbushes/ywflowers,
/obj/structure/flora/ausbushes/fernybush,
/obj/structure/window/shuttle,
/turf/open/floor/grass,
/area/shuttle/arrival)
"A" = (
/obj/machinery/vending/wallmed{
	name = "Emergency NanoMed";
	use_power = 0
	},
/turf/closed/wall/mineral/titanium/nodiagonal,
/area/shuttle/arrival)
"B" = (
/obj/effect/turf_decal/bot,
/obj/structure/chair/comfy/shuttle{
	dir = 1
	},
/obj/machinery/status_display/evac{
	pixel_y = -32
	},
/obj/machinery/light,
/turf/open/floor/mineral/plastitanium,
/area/shuttle/arrival)
"C" = (
/obj/item/radio/intercom{
	pixel_x = 28
	},
/obj/effect/turf_decal/stripes/corner,
/obj/effect/turf_decal/stripes/corner{
	dir = 1
	},
/obj/effect/turf_decal/stripes/corner{
	dir = 8
	},
/obj/effect/turf_decal/stripes/corner{
	dir = 4
	},
/turf/open/floor/noslip,
/area/shuttle/arrival)
"D" = (
/obj/effect/turf_decal/stripes/line,
/obj/machinery/door/airlock/shuttle{
	name = "Arrival Shuttle Airlock"
	},
/obj/effect/turf_decal/stripes/line{
	dir = 1
	},
/obj/effect/turf_decal/delivery,
/turf/open/floor/mineral/plastitanium,
/area/shuttle/arrival)
"E" = (
/obj/effect/turf_decal/stripes/line{
	dir = 4
	},
/obj/effect/turf_decal/stripes/line{
	dir = 8
	},
/turf/open/floor/noslip,
/area/shuttle/arrival)
"F" = (
/turf/open/floor/noslip,
/area/shuttle/arrival)
"G" = (
/obj/structure/shuttle/engine/propulsion/right{
	dir = 8
	},
/obj/effect/turf_decal/stripes/line{
	dir = 8
	},
/turf/open/floor/plating/airless,
/area/shuttle/arrival)
"H" = (
/obj/machinery/door/airlock/shuttle{
	name = "Arrival Shuttle Airlock"
	},
/turf/open/floor/plating,
/area/shuttle/arrival)
"I" = (
/obj/effect/turf_decal/stripes/line{
	dir = 8
	},
/turf/open/floor/noslip,
/area/shuttle/arrival)
"J" = (
/obj/effect/turf_decal/stripes/line{
	dir = 8
	},
/obj/effect/turf_decal/stripes/corner,
/obj/effect/turf_decal/stripes/corner{
	dir = 4
	},
/turf/open/floor/noslip,
/area/shuttle/arrival)
"K" = (
/obj/effect/turf_decal/stripes/line,
/obj/effect/turf_decal/stripes/line{
	dir = 1
	},
/turf/open/floor/noslip,
/area/shuttle/arrival)
"L" = (
/obj/machinery/status_display/ai,
/turf/closed/wall/mineral/titanium,
/area/shuttle/arrival)
"M" = (
/obj/effect/turf_decal/bot,
/obj/effect/turf_decal/stripes/corner{
	dir = 1
	},
/obj/machinery/light/small{
	dir = 8
	},
/obj/machinery/suit_storage_unit/ert,
/turf/open/floor/mineral/plastitanium,
/area/shuttle/arrival)
"N" = (
/obj/effect/turf_decal/bot,
/obj/structure/chair/comfy/shuttle{
	dir = 1
	},
/turf/open/floor/mineral/plastitanium,
/area/shuttle/arrival)
"O" = (
/obj/effect/turf_decal/stripes/corner{
	dir = 4
	},
/obj/effect/turf_decal/stripes/corner{
	dir = 8
	},
/obj/effect/turf_decal/stripes/corner{
	dir = 1
	},
/obj/effect/turf_decal/stripes/corner,
/turf/open/floor/noslip,
/area/shuttle/arrival)
"P" = (
/obj/effect/turf_decal/delivery,
/obj/item/tank/jetpack/oxygen,
/obj/item/tank/jetpack/oxygen,
/obj/item/tank/jetpack/oxygen,
/obj/item/tank/jetpack/oxygen,
/obj/structure/closet/crate,
/turf/open/floor/mineral/plastitanium,
/area/shuttle/arrival)
"R" = (
/obj/structure/grille,
/obj/structure/window/shuttle,
/turf/open/floor/plating,
/area/shuttle/arrival)
"S" = (
/obj/effect/turf_decal/stripes/line,
/obj/effect/turf_decal/stripes/line{
	dir = 1
	},
/obj/machinery/door/airlock/shuttle{
	name = "Arrival Shuttle Airlock"
	},
/turf/open/floor/plating,
/area/shuttle/arrival)
"U" = (
/obj/effect/turf_decal/delivery,
/obj/item/disk/tech_disk/debug,
/obj/item/circuitboard/machine/autolathe,
/obj/item/circuitboard/machine/techfab/department,
/obj/structure/closet/crate,
/turf/open/floor/mineral/plastitanium,
/area/shuttle/arrival)
"V" = (
/obj/effect/turf_decal/delivery,
/obj/structure/closet/crate/critter,
/mob/living/simple_animal/pet/cat/Runtime,
/turf/open/floor/mineral/plastitanium,
/area/shuttle/arrival)
"Y" = (
/obj/effect/turf_decal/bot,
/obj/machinery/suit_storage_unit/ert,
/turf/open/floor/mineral/plastitanium,
/area/shuttle/arrival)
"Z" = (
/obj/effect/turf_decal/delivery,
/turf/open/floor/mineral/plastitanium,
/area/shuttle/arrival)

(1,1,1) = {"
a
a
n
u
G
a
a
"}
(2,1,1) = {"
b
h
o
o
o
h
b
"}
(3,1,1) = {"
c
V
U
q
Z
P
c
"}
(4,1,1) = {"
d
m
r
m
J
E
H
"}
(5,1,1) = {"
e
j
w
s
K
x
e
"}
(6,1,1) = {"
f
k
w
y
K
N
f
"}
(7,1,1) = {"
R
k
w
z
K
N
f
"}
(8,1,1) = {"
R
k
w
A
K
N
f
"}
(9,1,1) = {"
c
l
w
i
K
B
c
"}
(10,1,1) = {"
S
E
C
E
O
E
H
"}
(11,1,1) = {"
b
c
c
D
L
c
b
"}
(12,1,1) = {"
c
e
t
I
M
e
c
"}
(13,1,1) = {"
g
c
Y
F
Y
c
g
"}
(14,1,1) = {"
g
c
f
f
f
c
g
"}
